##################################################
#................................................#
#..###########..###########..###########..######.#
#..#.........#..#.........#.........#..#......#..#
#..#.#######.#..#.#######.#.#######.#..#.######.##
#..#.#.....#.#..#.#.....#.#.#.....#..#.#......#..#
#..#.#.###.#.#..#.#.###.#.#.#.#####.#..#.######.##
#..#.#.#.#.#.#..#.#.#.#.#.#.#.#.....#..#........##
#..#.#.#.#.#.#..#.#.#.#.#.#.#.#.#####.############
#..#.#.#.#.#.#..#.#.#.#.#.#.#.#......#...........#
#..#.#.#.#.#.#############.#.#.#######.###########
#..#.#.#.#.#................#.#.#..........#.....#
#..#.#.#.#.###################.#.#.##########.#.##
#..#...#.#....................#.#.#..........#...#
#.########.#############.#######.#############...#.
#...........#.........#....................#.....#
#...........#.#######.#.##########.#######.#.#####
#.............#.....#...#................#.#.....#
###.#########.#.###.#.###.#.###########.#.#.######
#..............#...#...#.#.#..........#.#.#......#
#.#############.#.#####.#.#.#.########...#.#######
#...............#.......#.#.#...#......#..........
##################################################


